"aa" = (/turf/icon/white,/area/debug)
"ab" = (/turf/icon/white/blue,/area/debug)
"ac" = (/turf/icon/white/blue/corner,/area/debug)
"ad" = (/turf/icon/white/blue/corner{tag = "icon-whitebluecorner (EAST)"; icon_state = "whitebluecorner"; dir = 4},/area/debug)
"ae" = (/turf/icon/white/blue/corner{tag = "icon-whitebluecorner (NORTH)"; icon_state = "whitebluecorner"; dir = 1},/area/debug)
"af" = (/turf/icon/white/blue/corner{tag = "icon-whitebluecorner (WEST)"; icon_state = "whitebluecorner"; dir = 8},/area/debug)
"ag" = (/turf/icon/white/blue/full,/area/debug)
"ah" = (/turf/icon/plating,/area/debug)
"ai" = (/turf,/area/debug)
"aj" = (/turf/icon/white/bot,/area/debug)
"ak" = (/turf/icon/white/green,/area/debug)
"al" = (/turf/icon/white/green/corner,/area/debug)
"am" = (/turf/icon/white/green/corner{tag = "icon-whitegreencorner (EAST)"; icon_state = "whitegreencorner"; dir = 4},/area/debug)
"an" = (/turf/icon/white/green/corner{tag = "icon-whitegreencorner (NORTH)"; icon_state = "whitegreencorner"; dir = 1},/area/debug)
"ao" = (/turf/icon/white/green/corner{tag = "icon-whitegreencorner (WEST)"; icon_state = "whitegreencorner"; dir = 8},/area/debug)
"ap" = (/turf/icon/white/green/full,/area/debug)
"aq" = (/turf/spess,/area/debug)
"ar" = (/turf/icon/white/delivery,/area/debug)
"as" = (/turf/icon/white/purple,/area/debug)
"at" = (/turf/icon/white/purple/corner,/area/debug)
"au" = (/turf/icon/white/purple/corner{tag = "icon-whitepurplecorner (EAST)"; icon_state = "whitepurplecorner"; dir = 4},/area/debug)
"av" = (/turf/icon/white/purple/corner{tag = "icon-whitepurplecorner (NORTH)"; icon_state = "whitepurplecorner"; dir = 1},/area/debug)
"aw" = (/turf/icon/white/purple/corner{tag = "icon-whitepurplecorner (WEST)"; icon_state = "whitepurplecorner"; dir = 8},/area/debug)
"ax" = (/turf/icon/white/purple/full,/area/debug)
"ay" = (/turf/icon/white/red,/area/debug)
"az" = (/turf/icon/white/red/corner,/area/debug)
"aA" = (/turf/icon/white/red/corner{tag = "icon-whiteredcorner (EAST)"; icon_state = "whiteredcorner"; dir = 4},/area/debug)
"aB" = (/turf/icon/white/red/corner{tag = "icon-whiteredcorner (NORTH)"; icon_state = "whiteredcorner"; dir = 1},/area/debug)
"aC" = (/turf/icon/white/red/corner{tag = "icon-whiteredcorner (WEST)"; icon_state = "whiteredcorner"; dir = 8},/area/debug)
"aD" = (/turf/icon/white/red/full,/area/debug)
"aE" = (/turf/icon/carpet,/area/debug)
"aF" = (/turf/icon/white/yellow,/area/debug)
"aG" = (/turf/icon/white/yellow/corner,/area/debug)
"aH" = (/turf/icon/white/yellow/corner{tag = "icon-whiteyellowcorner (EAST)"; icon_state = "whiteyellowcorner"; dir = 4},/area/debug)
"aI" = (/turf/icon/white/yellow/corner{tag = "icon-whiteyellowcorner (NORTH)"; icon_state = "whiteyellowcorner"; dir = 1},/area/debug)
"aJ" = (/turf/icon/white/yellow/corner{tag = "icon-whiteyellowcorner (WEST)"; icon_state = "whiteyellowcorner"; dir = 8},/area/debug)
"aK" = (/turf/icon/white/yellow/full,/area/debug)
"aL" = (/turf/icon/blue/full,/area/debug)
"aM" = (/turf/icon/blue,/area/debug)
"aN" = (/turf/icon/blue{tag = "icon-blue (EAST)"; icon_state = "blue"; dir = 4},/area/debug)
"aO" = (/turf/icon/blue{tag = "icon-blue (NORTH)"; icon_state = "blue"; dir = 1},/area/debug)
"aP" = (/turf/icon/blue{tag = "icon-blue (NORTHEAST)"; icon_state = "blue"; dir = 5},/area/debug)
"aQ" = (/turf/icon/blue{tag = "icon-blue (NORTHWEST)"; icon_state = "blue"; dir = 9},/area/debug)
"aR" = (/turf/icon/blue{tag = "icon-blue (SOUTHEAST)"; icon_state = "blue"; dir = 6},/area/debug)
"aS" = (/turf/icon/blue{tag = "icon-blue (SOUTHWEST)"; icon_state = "blue"; dir = 10},/area/debug)
"aT" = (/turf/icon/blue{tag = "icon-blue (WEST)"; icon_state = "blue"; dir = 8},/area/debug)
"aU" = (/turf/icon/blue/corner,/area/debug)
"aV" = (/turf/icon/blue/corner{tag = "icon-bluecorner (EAST)"; icon_state = "bluecorner"; dir = 4},/area/debug)
"aW" = (/turf/icon/blue/corner{tag = "icon-bluecorner (NORTH)"; icon_state = "bluecorner"; dir = 1},/area/debug)
"aX" = (/turf/icon/blue/corner{tag = "icon-bluecorner (WEST)"; icon_state = "bluecorner"; dir = 8},/area/debug)
"aY" = (/turf/icon/blue/red,/area/debug)
"aZ" = (/turf/icon/blue/red{tag = "icon-bluered (EAST)"; icon_state = "bluered"; dir = 4},/area/debug)
"ba" = (/turf/icon/blue/red{tag = "icon-bluered (NORTH)"; icon_state = "bluered"; dir = 1},/area/debug)
"bb" = (/turf/icon/blue/red{tag = "icon-bluered (NORTHEAST)"; icon_state = "bluered"; dir = 5},/area/debug)
"bc" = (/turf/icon/blue/red{tag = "icon-bluered (NORTHWEST)"; icon_state = "bluered"; dir = 9},/area/debug)
"bd" = (/turf/icon/blue/red{tag = "icon-bluered (SOUTHEAST)"; icon_state = "bluered"; dir = 6},/area/debug)
"be" = (/turf/icon/blue/red{tag = "icon-bluered (SOUTHWEST)"; icon_state = "bluered"; dir = 10},/area/debug)
"bf" = (/turf/icon/blue/red{tag = "icon-bluered (WEST)"; icon_state = "bluered"; dir = 8},/area/debug)
"bg" = (/turf/icon/blue/yellow,/area/debug)
"bh" = (/turf/icon/blue/yellow{tag = "icon-blueyellow (EAST)"; icon_state = "blueyellow"; dir = 4},/area/debug)
"bi" = (/turf/icon/blue/yellow{tag = "icon-blueyellow (NORTH)"; icon_state = "blueyellow"; dir = 1},/area/debug)
"bj" = (/turf/icon/blue/yellow{tag = "icon-blueyellow (NORTHEAST)"; icon_state = "blueyellow"; dir = 5},/area/debug)
"bk" = (/turf/icon/blue/yellow{tag = "icon-blueyellow (NORTHWEST)"; icon_state = "blueyellow"; dir = 9},/area/debug)
"bl" = (/turf/icon/blue/yellow{tag = "icon-blueyellow (SOUTHEAST)"; icon_state = "blueyellow"; dir = 6},/area/debug)
"bm" = (/turf/icon/blue/yellow{tag = "icon-blueyellow (SOUTHWEST)"; icon_state = "blueyellow"; dir = 10},/area/debug)
"bn" = (/turf/icon/blue/yellow{tag = "icon-blueyellow (WEST)"; icon_state = "blueyellow"; dir = 8},/area/debug)
"bo" = (/turf/wall{density = 0; opacity = 0},/area/debug)
"bp" = (/turf/wood,/area/debug)
"bq" = (/turf/wood/broken/rand,/area/debug)
"br" = (/turf/wood/broken/states/s1,/area/debug)
"bs" = (/turf/wood/broken/states/s2,/area/debug)
"bt" = (/turf/wood/broken/states/s3,/area/debug)
"bu" = (/turf/wood/broken/states/s4,/area/debug)
"bv" = (/turf/wood/broken/states/s5,/area/debug)
"bw" = (/turf/wood/broken/states/s6,/area/debug)
"bx" = (/turf/wood/broken/states/s7,/area/debug)
"by" = (/turf/wood/missing,/area/debug)
"bz" = (/turf/icon/plating,/turf/wood/missing,/area/debug)
"bA" = (/turf/icon/asteroid,/area/debug)
"bB" = (/turf/icon/asteroid/rand,/area/debug)
"bC" = (/turf/icon/asteroid/states/s1,/area/debug)
"bD" = (/turf/icon/asteroid/states/s2,/area/debug)
"bE" = (/turf/icon/asteroid/states/s3,/area/debug)
"bF" = (/turf/icon/asteroid/states/s4,/area/debug)
"bG" = (/turf/icon/asteroid/states/s5,/area/debug)
"bH" = (/turf/icon/asteroid/states/s6,/area/debug)
"bI" = (/turf/icon/asteroid/states/s7,/area/debug)
"bJ" = (/turf/icon/asteroid/states/s8,/area/debug)
"bK" = (/turf/icon/asteroid/states/s9,/area/debug)
"bL" = (/turf/icon/asteroid/states/s10,/area/debug)
"bM" = (/turf/icon/asteroid/states/s11,/area/debug)
"bN" = (/turf/wall/reinforced{density = 0; opacity = 0},/area/debug)
"bO" = (/turf/icon/plating/dmg/states/s1,/area/debug)
"bP" = (/turf/icon/plating/dmg/states/s2,/area/debug)
"bQ" = (/turf/icon/plating/dmg/states/s3,/area/debug)
"bR" = (/turf,/area/debug/lit)
"bS" = (/obj/light/street_post,/turf,/area/debug/lit)
"bT" = (/obj/light,/turf,/area/debug/lit)
"bU" = (/obj/structure/rack,/turf,/area/debug)
"bV" = (/obj/landmark/start,/turf,/area/debug)
"bW" = (/obj/item/debugger,/turf,/area/debug)
"bX" = (/obj/structure/rack/special,/turf,/area/debug)

(1,1,1) = {"
aaabacadaeafagahahahahahahahahahahahahahahahahahahaiaiaiaiaiaiaiaiaiaiaiaiaiaiaiaiaiaiaiaiaiaiaiaiai
ajakalamanaoapahaqaqaqaqaqahahahahahahahahahahahahaiaiaiaiaiaiaiaiaiaiaiaiaiaiaiaiaiaiaiaiaiaiaiaiai
arasatauavawaxahaqaqaqaqaqahahahahahahahahahahahahaiaiaiaiaiaiaiaiaiaiaiaiaiaiaiaiaiaiaiaiaiaiaiaiai
ahayazaAaBaCaDahaqaqaqaqaqahaEaEahaEahaEahahahahahaiaiaiaiaiaiaiaiaiaiaiaiaiaiaiaiaiaiaiaiaiaiaiaiai
ahaFaGaHaIaJaKahaqaqaqaqaqahahahahaEahahaEahahahahaiaiaiaiaiaiaiaiaiaiaiaiaiaiaiaiaiaiaiaiaiaiaiaiai
ahahahahahahahahahahahahahahaEaEahahahahahahahahahaiaiaiaiaiaiaiaiaiaiaiaiaiaiaiaiaiaiaiaiaiaiaiaiai
aLaMaNaOaPaQaRaSaTahahahahahaEaEahaEaEaEahahahahahaiaiaiaiaiaiaiaiaiaiaiaiaiaiaiaiaiaiaiaiaiaiaiaiai
ahaUaVaWaXaiaiaiaiahahahahahahahahaEaEaEahahahahahaiaiaiaiaiaiaiaiaiaiaiaiaiaiaiaiaiaiaiaiaiaiaiaiai
ahaYaZbabbbcbdbebfahahahahahaEahahaEaEaEahahahahahaiaiaiaiaiaiaiaiaiaiaiaiaiaiaiaiaiaiaiaiaiaiaiaiai
ahbgbhbibjbkblbmbnahahahahaiaiaiaiaiaiaiaiaiaiaiahaiaiaiaiaiaiaiaiaiaiaiaiaiaiaiaiaiaiaiaiaiaiaiaiai
ahahahahahahahahahahahahahaiboboaiboaiboaiaiaiaiahaiaiaiaiaiaiaiaiaiaiaiaiaiaiaiaiaiaiaiaiaiaiaiaiai
bpbqahahahahahahahahahahahaiaiaiaiboaiaiboaiaiaiahaiaiaiaiaiaiaiaiaiaiaiaiaiaiaiaiaiaiaiaiaiaiaiaiai
ahbrbsbtbubvbwbxahahahahahaiboboaiaiaiaiaiaiaiaiahaiaiaiaiaiaiaiaiaiaiaiaiaiaiaiaiaiaiaiaiaiaiaiaiai
ahbybzahahahahahahahahahahaiboboaiboboboaiaiaiaiahaiaiaiaiaiaiaiaiaiaiaiaiaiaiaiaiaiaiaiaiaiaiaiaiai
ahahahahahahahahahahahahahaiaiaiaiboboboaiaiaiaiahaiaiaiaiaiaiaiaiaiaiaiaiaiaiaiaiaiaiaiaiaiaiaiaiai
bAbBahahahahahahahahahahahaiboaiaiboboboaiboboaiahaiaiaiaiaiaiaiaiaiaiaiaiaiaiaiaiaiaiaiaiaiaiaiaiai
ahbCbDbEbFbGbHbIbJbKbLbMahaiaiaiaiaiaiaiaibNbNaiahaiaiaiaiaiaiaiaiaiaiaiaiaiaiaiaiaiaiaiaiaiaiaiaiai
aiaiaiaiaiahahahahahahahahaibNbNaibNaibNaiaiaiaiahaiaiaiaiaiaiaiaiaiaiaiaiaiaiaiaiaiaiaiaiaiaiaiaiai
ahbObPbQaiahahahahahahahahaiaiaiaibNaiaibNaiaiaiahaiaiaiaiaiaiaiaiaiaiaiaiaiaiaiaiaiaiaiaiaiaiaiaiai
aiaiaiaiaiahahahahahahahahaibNbNaiaiaiaiaiaiaiaiahaiaiaiaiaiaiaiaiaiaiaiaiaiaiaiaiaiaiaiaiaiaiaiaiai
ahahahahahahahahahahahahahaibNbNaibNbNbNaiaiaiaiahaiaiaiaiaiaiaiaiaiaiaiaiaiaiaiaiaiaiaiaiaiaiaiaiai
ahahahahahahahahahahahahahaiaiaiaibNbNbNaiaiaiaiahaiaiaiaiaiaiaiaiaiaiaiaiaiaiaiaiaiaiaiaiaiaiaiaiai
ahahahahahahahahahahahahahaibNaiaibNbNbNaiaiaiaiahaiaiaiaiaiaiaiaiaiaiaiaiaiaiaiaiaiaiaiaiaiaiaiaiai
ahahahahahahahahahahahahahaiaiaiaiaiaiaiaiaiaiaiahaiaiaiaiaiaiaiaiaiaiaiaiaiaiaiaiaiaiaiaiaiaiaiaiai
ahahahahahahahahahahahahahahahahahahahahahahahahahaiaiaiaiaiaiaiaiaiaiaiaiaiaiaiaiaiaiaiaiaiaiaiaiai
ahahahahahahahahahahahahahahahahahahahahahahahahahaiaiaiaiaiaiaiaiaiaiaiaiaiaiaiaiaiaiaiaiaiaiaiaiai
ahahahahahahahahahahahahahahahahahahahahahahahahahaiaiaiaiaiaiaiaiaiaiaiaiaiaiaiaiaiaiaiaiaiaiaiaiai
aiaiaiaiaiaiaiaiaiaiaiaiaiaiaiaiaiaiaiaiaiaiaiaiaiaiaiaiaiaiaiaiaiaiaiaiaiaiaiaiaiaiaiaiaiaiaiaiaiai
aiaiaiaiaiaiaiaiaiaiaiaiaiaiaiaiaiaiaiaiaiaiaiaiaiaiaiaiaiaiaiaiaiaiaiaiaiaiaiaiaiaiaiaiaiaiaiaiaiai
aiaiaiaiaiaiaiaiaiaiaiaiaiaiaiaiaiaiaiaiaiaiaiaiaiaiaiaiaiaiaiaiaiaiaiaiaiaiaiaiaiaiaiaiaiaiaiaiaiai
bRbRbRbRbRbRbRbRbRbRbRbRbRbRbRbRbRbRbRaiaiaiaiaiaiaiaiaiaiaiaiaiaiaiaiaiaiaiaiaiaiaiaiaiaiaiaiaiaiai
bRbRbRbRbRbRbRbRbRbRbRbRbRbRbRbRbRbRbRaiaiaiaiaiaiaiaiaiaiaiaiaiaiaiaiaiaiaiaiaiaiaiaiaiaiaiaiaiaiai
bRbRbRbRbRbRbRbRbRbRbRbRbRbRbRbRbRbRbRaiaiaiaiaiaiaiaiaiaiaiaiaiaiaiaiaiaiaiaiaiaiaiaiaiaiaiaiaiaiai
bRbRbRbRbRbRbRbRbRbRbRbRbRbRbRbRbRbRbRaiaiaiaiaiaiaiaiaiaiaiaiaiaiaiaiaiaiaiaiaiaiaiaiaiaiaiaiaiaiai
bRbRbRbRbRbSbRbRbRbRbRbRbRbRbRbTbRbRbRaiaiaiaiaiaiaiaiaiaiaiaiaiaiaiaiaiaiaiaiaiaiaiaiaiaiaiaiaiaiai
bRbRbRbRbRbRbRbRbRbRbRbRbRbRbRbRbRbRbRaiaiaiaiaiaiaiaiaiaiaiaiaiaiaiaiaiaiaiaiaiaiaiaiaiaiaiaiaiaiai
bRbRbRbRbRbRbRbRbRbRbRbRbRbRbRbRbRbRbRaiaiaiaiaiaiaiaiaiaiaiaiaiaiaiaiaiaiaiaiaiaiaiaiaiaiaiaiaiaiai
bRbRbRbRbRbRbRbRbRbRbRbRbRbRbRbRbRbRbRaiaiaiaiaiaiaiaiaiaiaiaiaiaiaiaiaiaiaiaiaiaiaiaiaiaiaiaiaiaiai
bRbRbRbRbRbRbRbRbRbRbRbRbRbRbRbRbRbRbRaiaiaiaiaiaiaiaiaiaiaiaiaiaiaiaiaiaiaiaiaiaiaiaiaiaiaiaiaiaiai
aiaiaiaiaiaiaiaiaiaiaiaiaiaiaiaiaiaiaiaiaiaiaiaiaiaiaiaiaiaiaiaiaiaiaiaiaiaiaiaiaiaiaiaiaiaiaiaiaiai
aiaiaiaiaiaiaiaiaiaiaiaiaiaiaiaiaiaiaiaiaiaiaiaiaiaiaiaiaiaiaiaiaiaiaiaiaiaiaiaiaiaiaiaiaiaiaiaiaiai
aiaiaiaiaibUbVbWaiaiaiaiaiaiaiaiaiaiaiaiaiaiaiaiaiaiaiaiaiaiaiaiaiaiaiaiaiaiaiaiaiaiaiaiaiaiaiaiaiai
aiaiaiaiaibXaiaiaiaiaiaiaiaiaiaiaiaiaiaiaiaiaiaiaiaiaiaiaiaiaiaiaiaiaiaiaiaiaiaiaiaiaiaiaiaiaiaiaiai
aiaiaiaiaiaiaiaiaiaiaiaiaiaiaiaiaiaiaiaiaiaiaiaiaiaiaiaiaiaiaiaiaiaiaiaiaiaiaiaiaiaiaiaiaiaiaiaiaiai
aiaiaiaiaiaiaiaiaiaiaiaiaiaiaiaiaiaiaiaiaiaiaiaiaiaiaiaiaiaiaiaiaiaiaiaiaiaiaiaiaiaiaiaiaiaiaiaiaiai
aiaiaiaiaiaiaiaiaiaiaiaiaiaiaiaiaiaiaiaiaiaiaiaiaiaiaiaiaiaiaiaiaiaiaiaiaiaiaiaiaiaiaiaiaiaiaiaiaiai
aiaiaiaiaiaiaiaiaiaiaiaiaiaiaiaiaiaiaiaiaiaiaiaiaiaiaiaiaiaiaiaiaiaiaiaiaiaiaiaiaiaiaiaiaiaiaiaiaiai
aiaiaiaiaiaiaiaiaiaiaiaiaiaiaiaiaiaiaiaiaiaiaiaiaiaiaiaiaiaiaiaiaiaiaiaiaiaiaiaiaiaiaiaiaiaiaiaiaiai
aiaiaiaiaiaiaiaiaiaiaiaiaiaiaiaiaiaiaiaiaiaiaiaiaiaiaiaiaiaiaiaiaiaiaiaiaiaiaiaiaiaiaiaiaiaiaiaiaiai
aiaiaiaiaiaiaiaiaiaiaiaiaiaiaiaiaiaiaiaiaiaiaiaiaiaiaiaiaiaiaiaiaiaiaiaiaiaiaiaiaiaiaiaiaiaiaiaiaiai
"}
