"a" = (/turf,/area/debug)
"b" = (/obj/light/street_post,/turf,/area/debug)
"c" = (/obj/light,/turf,/area/debug)
"d" = (/turf{dynamic_lighting = 0; luminosity = 1; name = "fullbright turf"},/area/debug)
"e" = (/obj/structure/rack,/turf{dynamic_lighting = 0; luminosity = 1; name = "fullbright turf"},/area/debug)
"f" = (/obj/landmark/start,/turf{dynamic_lighting = 0; luminosity = 1; name = "fullbright turf"},/area/debug)
"g" = (/obj/item/debugger,/turf{dynamic_lighting = 0; luminosity = 1; name = "fullbright turf"},/area/debug)
"h" = (/obj/structure/rack/special,/turf{dynamic_lighting = 0; luminosity = 1; name = "fullbright turf"},/area/debug)

(1,1,1) = {"
aaaaaaaaaaaaaaaaaaaa
aaaaaaaaaaaaaaaaaaaa
aaaaaaaaaaaaaaaaaaaa
aaaaaaaaaaaaaaaaaaaa
aaaaabaaaaaaaaacaaaa
aaaaaaaaaaaaaaaaaaaa
aaaaaaaaaaaaaaaaaaaa
aaaaaaaaaaaaaaaaaaaa
aaaaaaaaaaaaaaaaaaad
dddddddddddddddddddd
dddddddddddddddddddd
dddddefgdddddddddddd
dddddhdddddddddddddd
dddddddddddddddddddd
dddddddddddddddddddd
dddddddddddddddddddd
dddddddddddddddddddd
dddddddddddddddddddd
dddddddddddddddddddd
dddddddddddddddddddd
"}
